11111111111111111111
10000000011000000001
10110110011001101101
10000000000000000001
10110101111110101101
10000100011000100001
11110110011001101111
11110100000000101111
11110101122110101111
00000001122110000000
11110101111110101111
11110100000000101111
11110101111110101111
10000000011000000001
10110110011001101101
10000100000000100001
11010101111110101011
10000000011000000001
10111110011001111101
10000000000000000001
11111111111111111111
